1111111111111111111111
1000001000000000000001
1000000000001100000001
1000001000000000000001
1000000010010000000001
1001000010000000100001
1000000000100000000001
1000111111111111110001
1000001000010000000001
1000001000000100000001
1010000001000000001001
1000000000000000001001
1000100000000110000001
1000000001000000000001
1111111111111111111111