1111111111111111111111111111111111111
1000000000000000000000000100000000001
1000001000000000000000000100000000001
1000001000000100000000000100000000001
1000001000001110000000111101000000001
1000001000000100000000100001000000001
1000001000000000000000111111000000001
1000111111111110000000000100000000001
1000000000000010000000000100000000001
1000000000000010000000000111000000001
1000000000000010000000000000000000001
1000000000000010000000000000000000001
1000000000000011111111111111100000001
1000000000000010000000100000000000001
1111111111000010000000100000000000001
1000000000000000000000100000001000001
1000000000000000000000100000001000001
1000001111000000000000100000001000001
1000001111000000000000000000001111111
1000001111000000000000100000000000001
1000000000000000000000100000000000001
1111111111111111111111111111111111111
