1111111111111111111111111111111111111111111111111111111111111111111111
1000000001000000000000000000000000110000000000000000000000000000000001
1000000001000000000000000000000000110000000000000000000000000000000001
1000000001000000000000000000000000110000000000000000000000000000000001
1111000111000000000000000000000000110000000000000000000000000000000001
1000000000000000000000000000000000000000000111111111110000000000000001
1000000000000000000000100000000000000000000000000000000000000000000001
1000000000000000000000010000000000000000000000000000000000000000000001
1000000000000000000000001000000000000000000000000000000000000000000001
1000000000000000000000000100000000000000000000000000000000000000000001
1000000000000000000000000010000000000000000000000000000000000000000001
1000000000000000000000000000000000000000000000000000000000000000000001
1000000000000000000000000000000000000000000011111111111100000000000001
1000000000000000000000010001000000000000000000000000000100000000000001
1000000000000000000000001010000000000000000000000000000100000000000001
1000000000000000000000000100000000000000000000000000000100000000000001
1000000000000000000000001010000000000000000011111111111100000000000001
1000000000000000000000010001000000000000000000000000000000000000000001
1000000000000000000000000000000000000000000000000000000000000000000001
1111111111111000000000000000000000000000000000000000000000000000000001
1000000000000000000000000000000000000000000000000000000000000000000001
1000000000000000000000000000000000000000000000000000000000000000000001
1000000000001000000000000000000000000000000000000000000000000000000001
1000000000001000000000000000000000000000000000000000000000000000000001
1111111111111111111111111111111111111111111111111111111111111111111111